{
    "width": 15,
    "height": 12,
    "data": [18, 45, 41, 41, 60, 18, 18, 47, 41, 41, 41, 41, 46, 18, 18,
        45, 42, 2, 2, 17, 6, 7, 4, 2, 2, 2, 2, 40, 46, 18,
        29, 17, 2, 2, 17, 19, 20, 4, 2, 2, 5, 2, 4, 40, 46,
        29, 17, 2, 2, 72, 32, 33, 34, 2, 2, 2, 2, 4, 4, 27,
        29, 57, 97, 53, 53, 54, 54, 53, 53, 53, 53, 55, 61, 4, 27,
        29, 56, 53, 53, 67, 54, 81, 53, 53, 53, 92, 53, 55, 61, 27,
        29, 56, 53, 53, 54, 54, 53, 53, 53, 53, 83, 53, 53, 56, 27,
        29, 56, 53, 53, 54, 54, 53, 53, 53, 53, 83, 53, 53, 56, 27,
        29, 56, 53, 53, 80, 54, 68, 53, 53, 53, 83, 53, 53, 56, 27,
        18, 36, 84, 53, 53, 80, 54, 68, 53, 53, 95, 53, 71, 35, 18,
        18, 18, 18, 36, 84, 53, 54, 54, 53, 53, 53, 71, 35, 18, 18,
        18, 18, 18, 18, 18, 18, 54, 54, 18, 18, 18, 18, 18, 18, 18],
    "offset": -1
}